2222222222
2222000002
2224302002
2243022002
2000222002
2000000002
2000000002
2332222002
2442222012
2222222222
